################
#      @       #
#              #
#              #
#              #
#              #
#              #
#########      #
#              #
#  #############
#              #
#              #
############   #
#              #
#           XXX#
################
